 XXXXXXXXX
 XXXXXXXXX
    XXXXXX
XXX XX   X
XXX XX X X
       X X
 XXXXXXX X
 XXXX    X
XXXXXXXX X
XXXXXXXXDX