 XXXXXXXXXXXXXXXX
        XXXXXXXX 
XXX X XXXXX   XXX
XXXX  X XXX XX XX
XXXXXXX XXX XX XX
XXXXXXX     X X X
XXXXXXXX X XXXXXX
XXXXXXXXX   XX  D
